111111111
110000001
100010001
10P1000C1
100000E01
111111111