111111111
1P0000001
100000001
1000000C1
100000E01
111111111