11111111111111
1000000C0000N1
1000000000CC01
1000P001000001
10000000000001
100000CCC00001
1E0000CCC00001
111000CCC00C01
10000000000001
11111111111111
