111111111111111111111111
1P0000000000000000000001
100000000000000000000001
1000CCC0000CC00000CC0001
1000C00000C00C0000C0C001
10000C0000CCCC0000C00C01
100000C000C00C0000C0C001
1000CCC000C00C0000CC0001
10N000000000000000000001
100000000000000000000001
100000000000000000000001
1000000000000000000000E1
111111111111111111111111